SSSSSSSZSSSSSSSSSSSZ
SSZSSSSSSSSZSSSSSSSS
SSSZSSSSSSSSZSSSSSSS
SSSSSSSSSSSSSSSZSSSS
SSSSSSSSSSSSSSSSSSSS
ZSZSSZSSSSZSSSSSSZSS
SSSSZSSZSSSZSSSSSSSS
SZSSSSSSSSSSSSSZSSZS
SSSZSSSSSZSSSSSSSSSS
SSSSSSSSSSZSSSSZSSSS
SSSSSSSSSSSSSSSSSSSS
SSZSSSSSSSSSSSSSSSSS
SSSSSSSSSSSSZSSSSSSS
SSSSSSZSSZSSSSSSSZZS
SSSSSSSZSSSSSZSSSSSS
SSSSSZSSZSZSSSSSSSSS
ZSSSSSSSSSSZSSSSSSSS
SSZSSSSSSZSSZSZZSSSS
SZSSSSZSSSSSSSZSSZSS
SSSZSSSZSSSSSSSZSSSS
